NO wall/wall_3.xpm42
SO wall/wall_1.xpm42
EA wall/wall_4.xpm42

F 255,255,125


WE wall/wood.xpm42
C 225,30,50     
                                                                                                                      

1111111111111111111111111111111111111111111111111111111111111111111111111111111111111111111111111111111111
10000000000000000000000000000000000000000000000000000000000000000000000000000000000000000000000000000000W1
1000000000000000000000000000000000000000000000000000000000000000000000000000000000000000000000000000000001
1000000000000000000000000000000000000000000000000000000000000000000000000000000000000000000000000000000001
1000000000000000000000000000000000000000000011111111111111111100000000000000000000000000000000000000000001
1000000000000000000000000000000000000000000011111111111111111100000000000000000000000000000000000000000001
1000000000000000000000000000000000000000000011111111111111111100000000000000000000000000000000000000000001
1000000000000000000000000000000000000000000000000000000000000000000000000000000000000000000000000000000001
1111111111111111111111111111111111111111111111111111111111111111111111111111111111111111111111111111111111
